tremendous		to lớn
impact		tác động
ch1:
ch2: Writting a Module
intentionally		cố ý
prior		trước khi
indicates		chỉ ra

ch3:
huge		lớn
contrlversial	bàn cải được
pay to		trả tiền để
chance		cơ hội
particular		cụ thể
candidates	ứng cử viên
straightforward	minh bạch, ngay thẳng
consulted		tham khảo
distinguish	phân biệt, nhận ra
stashing		
traditional	truyền thống
delegated to	giao cho

ch4: the menu system
respondsibilities	trách nhiệm
wildcards		ký hiệu
inventory		kiểm kê, tồn kho
quietly		lặng lẽ, âm thầm
experiment	thử nghiệm
foregoing		đã nói trên
interfere		can thiệp

ch5: working with database
drudgery		làm cực nhọc, làm vất vả
fret		băn khoăn
precision		chính xác, rỏ ràng
permanent	vĩnh viễn, luôn luôn, thường xuyên

ch6: Working with Users
collaborate	hợp tác, cộng tác
inspected		kiểm tra
variants		biến thể
arbitrary		tùy ý, tự tiện, chuyên quyền